Bulgarian bg
Chinese (Simplified)	zh-CN
Chinese (Traditional)	zh-TW
Czech	cs
Danish	da
Dutch	nl
English	en
Finnish	fi
French	fr
German	de
Greek	el
Hungarian	hu
Indonesian	id
Italian	it
Japanese	ja
Korean	ko
Norwegian	no
Polish	pl
Portuguese	pt
Portuguese-Brazil	pt-BR
Romanian	ro
Russian	ru
Spanish-Spain	es
Spanish-Latin-america es-419
Swedish	sv
Thai	th
Turkish	tr
Ukrainian	uk
Vietnamese	vn